{ "lives":20,
  "startingGold":5,
  "offset":{"x":-3,"y":-4},
  "tileMap":[
    [ 1, 4, 0, 8, 1, 1, 1, 1],
    [ 1, 4, 0, 8, 1, 1, 1, 1],
    [ 1, 4, 0, 8, 1, 1, 1, 1],
    [ 1, 4, 0, 8, 1, 1, 1, 1],
    [ 1, 4, 0, 8, 1, 1, 1, 1],
    [ 1, 4, 0, 7, 6, 1, 1, 1],
    [ 1, 4, 0, 0, 0, 8, 1, 1],
    [ 1, 1, 2, 3, 0, 7, 6, 6],
    [ 1, 1, 1, 4, 0, 0, 0,10],
    [ 1, 1, 1, 1, 2, 2, 2, 2]
  ],
  "path":[
    {"x":2, "y":0},
    {"x":2, "y":6},
    {"x":4, "y":6},
    {"x":4, "y":8},
    {"x":6, "y":8}
  ]
}