{ "lives":20,
  "startingGold":5,
  "offset":{"x":-3,"y":-4},
  "tileMap":[
    [ 9, 2, 2, 2, 2, 2, 2, 2, 2, 2, 3],
    [ 8, 1, 1, 1, 1, 1, 1, 1, 6, 6, 5],
    [ 8, 1, 6, 6, 6, 6, 1, 4, 0, 0, 10],
    [ 8, 4, 0, 0, 0, 0, 8, 4, 0, 9, 3],
    [ 8, 4, 0, 9, 3, 0, 8, 4, 0, 8, 4],
    [ 8, 4, 0, 8, 4, 0, 8, 4, 0, 8, 4],
    [ 8, 4, 0, 8, 4, 0, 7, 5, 0, 8, 4],
    [ 8, 4, 0, 8, 4, 0, 0, 0, 0, 8, 4],
    [ 8, 4, 0, 8, 1, 2, 2, 2, 2, 1, 4],
    [ 8, 4, 0, 8, 1, 1, 1, 1, 1, 1, 4],
    [ 7, 4, 0, 8, 6, 6, 6, 6, 6, 6, 5]
  ],
  "path":[
    {"x":2, "y":10},
    {"x":2, "y":3},
    {"x":5, "y":3},
    {"x":5, "y":7},
    {"x":8, "y":7},
    {"x":8, "y":2},
    {"x":9, "y":2}
  ]
}