{ "lives":20,
  "startingGold":5,
  "offset":{"x":-3,"y":-4},
  "tileMap":[
    [ 1, 1, 1, 1, 1, 1, 1, 1, 1, 1, 1],
    [ 1, 1, 1, 1, 1, 1, 1, 1, 6, 6, 6],
    [ 1, 1, 6, 6, 6, 6, 1, 4, 0, 0, 10],
    [ 1, 4, 0, 0, 0, 0, 8, 4, 0, 9, 2],
    [ 1, 4, 0, 9, 3, 0, 8, 4, 0, 8, 1],
    [ 1, 4, 0, 8, 4, 0, 8, 4, 0, 8, 1],
    [ 1, 4, 0, 8, 4, 0, 7, 5, 0, 8, 1],
    [ 1, 4, 0, 8, 4, 0, 0, 0, 0, 8, 1],
    [ 1, 4, 0, 8, 1, 2, 2, 2, 2, 1, 1],
    [ 1, 4, 0, 8, 1, 1, 1, 1, 1, 1, 1],
    [ 1, 4, 0, 8, 1, 1, 1, 1, 1, 1, 1]
  ],
  "path":[
    {"x":2, "y":10},
    {"x":2, "y":3},
    {"x":5, "y":3},
    {"x":5, "y":7},
    {"x":8, "y":7},
    {"x":8, "y":2},
    {"x":9, "y":2}
  ]
}